well - you Suck
new update - for this suck
spy main of - dick in the world
fridaynightshia - fnfSpiderMan
pico go - fuck
this engine - is very heavy
help my brain - go fack you self
aaaaaaaaaaaaaaaaaaaaa - aaaaaaaaaaaaaaaaa
intro the - mandness
thanks for download - this shit
now go make mods now - Im serious
there are several secrets in this engine - and will have very soon
console will be a good weapon against engine - being mean
say hello to newgrounds - UGH
new modes - to cry
new shits - to dance
3 boyfriends secrets - 1 of them is very powerful
my dick - not ok
blalbalbalbla - blablalba
i like eurobeat - best drift car in ancient times hachi-roku
speedy speed boy - gasolines burnin
Love is in danger it is gonna die - Love is the saver it got to survive
Welcome to my rocky show - Welcome to the fire of the night
They all said Id best give it up - Are you ready now to die
well - the end
pow - nope
this is shit - I dont know what to put
ChocoZylux - Is Chocolate
bruh - my team
i as spy main - but o live trickstabs